%%%%%
%  P%
%   %
%.  %
%%%%%
